Sample Frupal Game
8
######################
1,1
100
0
Axe
some
new
items
to
have
ok?
Diamond Sword
######################
0,0,0,0,Diamonds
0,1,0,0,None
0,2,0,0,None
0,3,0,0,None
0,4,0,0,None
0,5,0,0,None
0,6,0,0,None
0,7,0,0,None
1,0,0,0,None
1,1,0,0,None
1,2,0,0,None
1,3,0,0,None
1,4,0,0,None
1,5,0,0,None
1,6,0,0,None
1,7,0,0,None
2,0,0,0,None
2,1,0,0,None
2,2,0,0,None
2,3,0,0,None
2,4,0,0,None
2,5,0,0,None
2,6,0,0,None
2,7,0,0,None
3,0,0,0,None
3,1,0,0,None
3,2,0,0,None
3,3,0,0,None
3,4,0,0,None
3,5,0,0,None
3,6,0,0,None
3,7,0,0,None
4,0,0,0,None
4,1,0,0,None
4,2,0,0,None
4,3,0,0,None
4,4,0,0,None
4,5,0,0,None
4,6,0,0,None
4,7,0,0,None
5,0,0,0,None
5,1,0,0,None
5,2,0,0,None
5,3,0,0,None
5,4,0,0,None
5,5,0,0,None
5,6,0,0,None
5,7,0,0,None
6,0,0,0,None
6,1,0,0,None
6,2,0,0,None
6,3,0,0,None
6,4,0,0,None
6,5,0,0,None
6,6,0,0,None
6,7,0,0,None
7,0,0,0,None
7,1,0,0,None
7,2,0,0,None
7,3,0,0,None
7,4,0,0,None
7,5,0,0,None
7,6,0,0,None
7,7,0,0,None